RANK,USER,TOTAL,GATE,DELAY,TICK
1,Beesman,112,102,10,
2,Namseeb,125,113,12,
3,梦想,133,111,22,
4,沈逍遥(Q群746497406),133,111,22,
5,1547938354,133,111,22,
6,altrag,135,113,22,
7,SunCat,135,113,22,
8,overcomplexification,135,113,22,
9,Volatility,135,113,22,
10,thompsotd,138,116,22,
11,Diggsey,138,114,24,
12,Xilu,142,130,12,
13,Nick2oo2,145,117,28,
14,Wanglemink Fannycourt,145,119,26,
15,kzotn,145,119,26,
16,danielrab,148,118,30,
17,MicroBuilder,149,123,26,
18,Gelthor,150,122,28,
19,YukiYasai,151,121,30,
20,tctianchi,153,129,24,
21,[CrAzY]WC,156,128,28,
22,OneOfTheChips,156,128,28,
23,bmerry,160,132,28,
24,EPRORA,161,135,26,
25,yut23,161,135,26,
26,AJ,161,135,26,
27,toke,161,135,26,
28,Brawndo,162,134,28,
29,GinjaNinja32,162,134,28,
30,Zarchonia,162,134,28,
31,Mayge,162,134,28,
32,schadocalex,163,135,28,
33,Mr Pebble,163,133,30,
34,babycakesmittens,163,141,22,
35,BlockOG,163,143,20,
36,Fungi,163,133,30,
37,hannah,164,134,30,
38,Weesplat,165,133,32,
39,kmcguffi,165,135,30,
40,zuev93,166,138,28,
41,Oreo,166,134,32,
42,san_skylak,167,139,28,
43,MasterJason9637,167,141,26,
44,worstedmoon8,167,137,30,
45,Zarsatha,168,136,32,
46,G0rger,170,146,24,
47,ranger\_e\_p,171,143,28,
48,Yunfeng,172,148,24,
49,ZeroFarad,174,140,34,
50,iota,175,143,32,
51,al13n,175,133,42,
52,EmmaTheGiant,175,145,30,
53,Boomshroom,175,145,30,
54,O2,175,147,28,
55,Heistenberg99,177,145,32,
56,PatitoPatozo,177,141,36,
57,CitrusMarmelade,179,153,26,
58,HowToCantaloupe,179,153,26,
59,grkt125,180,154,26,
60,RealOfficialTurf,181,155,26,
61,Kisse Mjolk,181,155,26,
62,petermax,181,155,26,
63,Nari,182,138,44,
64,mhkw,182,154,28,
65,Mizar,182,156,26,
66,4xel,182,154,28,
67,micha_i,183,139,44,
68,ardeej,183,155,28,
69,Martin,183,155,28,
70,Arnavion,184,154,30,
71,pleegwat,184,138,46,
72,Krang,184,150,34,
73,GusPwouet,184,138,46,
74,The Moon Itself,186,160,26,
75,c\_user,186,158,28,
76,simonsays095,186,158,28,
77,Quent,186,158,28,
78,UwU,186,158,28,
79,Stabhole,186,158,28,
80,alexanderpas,187,161,26,
81,sdk,187,159,28,
82,pichutarius,187,159,28,
83,white-gandalf,187,157,30,
84,Endershadow,188,162,26,
85,WhIrLwinD356,188,162,26,
86,agrimes,188,146,42,
87,VaporGame,188,162,26,
88,erinsc,188,162,26,
89,reklrekl,188,162,26,
90,Havenvik,188,162,26,
91,skyhgzsh,188,160,28,
92,Rartrin,189,161,28,
93,Carl-ified,189,161,28,
94,Yanni128,189,161,28,
95,V A P E Jr.,189,161,28,
96,Jay,190,142,48,
97,Pine,190,164,26,
98,Legy,190,156,34,
99,PinkyWinky,190,148,42,
100,Niels,190,164,26,
101,olorin3125,190,148,42,
102,dont b mad cuz im bad,190,148,42,
103,SubCine,190,158,32,
104,Alex,191,163,28,
105,Vincent Cardley,191,163,28,
106,mm,191,149,42,
107,Thism2,191,165,26,
108,The Wind,191,147,44,
109,Random\_Magus,191,163,28,
110,LPKoyara,192,164,28,
111,D,192,164,28,
112,SamsonTheCat81,193,167,26,
113,Välling,193,163,30,
114,柴,193,163,30,
115,wangperiagoge,193,165,28,
116,seconddifferential,194,146,48,
117,MegaIng,194,164,30,
118,orangesnowfox,194,156,38,
119,Whisper,194,164,30,
120,Auto(Dada)Didact,194,164,30,
121,%,194,168,26,
122,dragmine149,194,164,30,
123,naitchal,194,162,32,
124,nqpk,194,164,30,
125,RayRay26,195,155,40,
126,Teun2408,195,163,32,
127,kiseru,195,169,26,
128,Dim_ov,195,163,32,
129,Nottingphile,195,163,32,
130,liuhang10,195,167,28,
131,McModknower,196,154,42,
132,Khorne Sanguine,196,164,32,
133,krangelang,196,164,32,
134,RyuTurtle,196,170,26,
135,kenpeter,196,164,32,
136,ramuDotZip,196,164,32,
137,HURGMCGURG,196,162,34,
138,alex\_strel,196,164,32,
139,=^・^=,196,164,32,
140,cswvna,197,153,44,
141,LeeFun,197,155,42,
142,Wylentar,197,153,44,
143,joflo,197,155,42,
144,GasInfinity,197,155,42,
145,ABIGplayer,197,165,32,
146,Zhooka,197,155,42,
147,Nulano,198,168,30,
148,2e19728,198,158,40,
149,tobotrieb,198,166,32,
150,pahlke,198,156,42,
151,Dark,198,156,42,
152,Reyquiem,198,154,44,
153,mediosthenes,199,153,46,
154,NicolaeHC,199,171,28,
155,Codegen42,199,149,50,
156,PythonPlusPlus,200,158,42,
157,LittleDemon2,200,172,28,
158,RoyalBlue,200,172,28,
159,Glen Runciter,200,156,44,
160,HapyD,201,157,44,
161,Quantic Mage,201,165,36,
162,tahgtahv,202,156,46,
163,hungcat,202,156,46,
164,Oshisaure,202,156,46,
165,hb_wales,202,156,46,
166,Renji,202,156,46,
167,UltraPeeks,202,156,46,
168,m_ornj,202,162,40,
169,couch_lizzard,202,156,46,
170,NO_NAME,202,156,46,
171,PhiliPdB,202,176,26,
172,guy-732,202,156,46,
173,NarcissusGray,202,156,46,
174,bearb,202,156,46,
175,nabla,202,156,46,
176,masato,202,156,46,
177,botondmester,202,156,46,
178,rossc719,202,156,46,
179,toms11235,202,156,46,
180,bisc,202,156,46,
181,hzxsncz,202,156,46,
182,mccoyn,202,156,46,
183,璐明,202,156,46,
184,9527,202,156,46,
185,theodor.hayden,202,156,46,
186,Pakanaateisti,203,157,46,
187,没有用,203,173,30,
188,gerritvanroekel,203,175,28,
189,#TSwagg,204,162,42,
190,LMD|Cavy,204,172,32,
191,The Solar Admiral,204,158,46,
192,Dennyout65,204,172,32,
193,Threemanager996,204,172,32,
194,stockholm,204,172,32,
195,愣橙子,204,172,32,
196,fifthman6377,204,172,32,
197,StupidCAI,204,170,34,
198,teseting,204,172,32,
199,ZayDekX,204,172,32,
200,[NrdZ] Saboteiro,204,172,32,
201,Gaming,204,172,32,
202,天境回廊,204,172,32,
203,Joker\_vD,204,172,32,
204,Dial-up King,204,172,32,
205,theAmazingJunkman,205,159,46,
206,dbxl,205,177,28,
207,Chuck,206,180,26,
208,Marqho,206,158,48,
209,HK\_Koutan,206,172,34,
210,WW,206,158,48,
211,Zebadiah,207,165,42,
212,Zenoxide,207,175,32,
213,tyryi,208,176,32,
214,thanis80,208,164,44,
215,Broncos5894,208,174,34,
216,Ukilop,208,178,30,
217,,208,180,28,
218,Cygwin231,208,166,42,
219,fort,208,182,26,
220,DarthOrdo,209,175,34,
221,ã‹ã‚ã‚ï½¥ã¡ãŸçŒ«,209,177,32,
222,Kertox662,209,165,44,
223,Fififionek,209,173,36,
224,Itehnological,210,168,42,
225,Supersonic Pixel Junkie,210,166,44,
226,Arok,210,176,34,
227,Errs Anyway,211,159,52,
228,Pannoni,211,177,34,
229,martyn1842,211,169,42,
230,MrFixxiT,211,187,24,
231,Chech,212,180,32,
232,tooro,212,174,38,
233,ylide,212,190,22,
234,sadovnikovss,212,180,32,
235,decesare,213,165,48,
236,Hayt,213,173,40,
237,benlingan,213,171,42,
238,meyn,213,171,42,
239,oinkymomo,213,171,42,
240,eagle0600,213,169,44,
241,srjek,213,169,44,
242,78715859,213,191,22,
243,cringemaster420,214,170,44,
244,Txoka,214,184,30,
245,cleantted,214,170,44,
246,Etoplay,215,187,28,
247,taio,215,175,40,
248,LeviDuncan,215,171,44,
249,Dzwho,215,183,32,
250,Deadly Usagi,216,172,44,
251,Strubbelkopp,216,170,46,
252,dudfo0629,216,188,28,
253,egerke,216,172,44,
254,unknown\_err,216,182,34,
255,krsnik,216,172,44,
256,Dante,216,186,30,
257,VeliTomaatti,216,186,30,
258,PomPong,216,172,44,
259,El Presidente,217,167,50,
260,Metricor,217,175,42,
261,ArcticCopper,218,172,46,
262,wbradley1372,218,184,34,
263,tcz717,218,172,46,
264,Dravyk,218,172,46,
265,the,218,188,30,
266,Sonullx Liu,218,172,46,
267,albanboissard,218,176,42,
268,white woman gaming,218,196,22,
269,old\_one\_15,218,174,44,
270,kamkubad,218,172,46,
271,Egginator,218,188,30,
272,三风,218,172,46,
273,Sebastian Sokolova,218,172,46,
274,Hesulan,219,173,46,
275,blackthorn,219,187,32,
276,Soul,219,179,40,
277,Soso,220,168,52,
278,Sapphire,220,188,32,
279,TriM,220,184,36,
280,Leek Amadeus,220,188,32,
281,rexgene,220,190,30,
282,sohusi,220,188,32,
283,TonyQ,220,190,30,
284,iwikal,221,175,46,
285,Y e v v i.,221,175,46,
286,Kedesiklem,221,171,50,
287,Moonj64,221,171,50,
288,ネット・イメージ,221,191,30,
289,asafonnikov,221,191,30,
290,Wish,221,171,50,
291,jlntlln7,221,171,50,
292,Hl 13,221,167,54,
293,eryk500,221,189,32,
294,moccam,221,177,44,
295,19857180048,221,173,48,
296,jamatt0443,222,174,48,
297,Captain\_Scraptin,222,188,34,
298,kaerim.frempong,222,192,30,
299,Chegg,222,186,36,
300,DarthSack,222,188,34,
301,Swan,223,183,40,
302,牛百叶,224,152,72,
303,Xi ^ Xi,224,172,52,
304,tdog21,224,184,40,
305,elgecko,225,155,70,
306,rphsw,225,181,44,
307,Nefarious Zhen,225,171,54,
308,Ryan,225,155,70,
309,qianyinjun2009,225,155,70,
310,Pr0st,226,172,54,
311,Jeutian,226,176,50,
312,PotatoInTheBox,226,192,34,
313,Ravenspear,226,196,30,
314,SeWZC,226,180,46,
315,Jimmy Russell,227,181,46,
316,OggyWan71,227,181,46,
317,CatMan62101,227,181,46,
318,Slim Pickens,227,177,50,
319,10usb,228,186,42,
320,vanilkovy.puding *****,228,180,48,
321,Das Keifer,228,184,44,
322,\_4Z\_,228,174,54,
323,wobs,228,174,54,
324,Iliou,228,176,52,
325,*****,229,155,74,
326,克里斯托夫古兰马克索特,229,185,44,
327,roran,229,201,28,
328,崂山小妖怪,229,191,38,
329,Louis,229,197,32,
330,stellartux,230,156,74,
331,BierLiebHaber,230,156,74,
332,FireStorm,230,156,74,
333,Skepfyr,230,156,74,
334,Niet,230,156,74,
335,Sagoot,230,156,74,
336,Fri3dNstuff,230,156,74,
337,slowwalker,230,156,74,
338,Apithia,230,156,74,
339,Jist,230,156,74,
340,CyberCat,230,156,74,
341,Venusaur,230,156,74,
342,minekpo1,230,156,74,
343,xborg0,230,156,74,
344,Moriibund,230,194,36,
345,semmaz,230,198,32,
346,S!mon,230,158,72,
347,Chri5p,230,156,74,
348,123,230,200,30,
349,Erunion,230,156,74,
350,Pants,230,198,32,
351,The Great Detective,230,204,26,
352,Cooyon,230,156,74,
353,358580794,230,158,72,
354,King,230,158,72,
355,JSXDH,230,188,42,
356,Manilock,230,156,74,
357,四维汉堡包,230,156,74,
358,jshintaro1018,230,156,74,
359,Ugly Fat Jerk,231,195,36,
360,JOHNF,231,197,34,
361,ElectroMagneticCyclone,231,197,34,
362,Peadge,232,162,70,
363,robbe.vsb,232,194,38,
364,zagadka M,232,180,52,
365,bill.ruddock,232,180,52,
366,NotAnAaardvark,232,186,46,
367,MTReis86,233,173,60,
368,startskate974,233,199,34,
369,BekfastStealer,233,191,42,
370,nathancrazy5,233,191,42,
371,getItemFromBlock,233,189,44,
372,wuxiaofu2004,233,205,28,
373,Pinekiller,233,209,24,
374,AlphaDaddy,233,205,28,
375,prphet,234,186,48,
376,kamikater,234,164,70,
377,almafa64,234,174,60,
378,wanicca,234,190,44,
379,0xDEADC0DE,234,202,32,
380,White Rice,234,190,44,
381,radu124,234,196,38,
382,LanzaJ,234,196,38,
383,nicholas.sommer,235,203,32,
384,ryani,235,159,76,
385,Bronze,235,175,60,
386,LocumRandomBot,235,189,46,
387,Celforyon,235,183,52,
388,mabretor,235,165,70,
389,gomidame,236,166,70,
390,TheDalekDoctor,236,188,48,
391,shigawire,236,208,28,
392,diaoyf,236,198,38,
393,simon.goldsmith,236,186,50,
394,Jao,236,198,38,
395,PotatoLoRD,237,193,44,
396,tali713,237,191,46,
397,Trixi,237,195,42,
398,koutianyi,237,165,72,
399,macho,237,195,42,
400,sleepprogger,238,166,72,
401,Huginn,238,188,50,
402,(2^5)*41,238,190,48,
403,alya94,238,188,50,
404,yuriks,238,188,50,
405,璜珀,238,188,50,
406,danie59823,238,192,46,
407,AllPlayars,238,190,48,
408,Alef Burzmali,238,164,74,
409,Riviera,238,180,58,
410,joachim,238,194,44,
411,flederohr,239,193,46,
412,Fieloxx,239,197,42,
413,lothar243,239,189,50,
414,0xmeow,239,177,62,
415,西伯利亚的猫猫,239,191,48,
416,杜诗,239,203,36,
417,Jubskleiton,240,204,36,
418,gary,240,200,40,
419,Luedga,240,196,44,
420,Soup Girl,240,204,36,
421,Aart Bluestoke,240,204,36,
422,yiqiao369,240,190,50,
423,hirosem,241,181,60,
424,FreeBird,241,211,30,
425,Schyrsivochter,241,201,40,
426,Strange2018,241,199,42,
427,tienchai,241,167,74,
428,Torisumi\_horou,241,213,28,
429,Alcyr,241,207,34,
430,adderd,241,171,70,
431,ThatWasADemo,241,171,70,
432,flemmingvonessen,242,166,76,
433,ThePanicDev,242,196,46,
434,Lillie,242,196,46,
435,FoxSlyme,242,204,38,
436,MetalMutton,242,194,48,
437,Qubic,242,170,72,
438,chloe,242,204,38,
439,yyyy,242,208,34,
440,bahman362,243,205,38,
441,Sloane,243,171,72,
442,Esrome the Strange,243,203,40,
443,zamadatix,243,185,58,
444,Yltw,243,171,72,
445,Orochimarufan,243,197,46,
446,Sigmanificient,243,203,40,
447,Cosmia,243,173,70,
448,qq11123334,243,179,64,
449,nick,244,196,48,
450,ferrisfox,244,208,36,
451,peterpeladon,244,172,72,
452,カエル軍団,244,176,68,
453,Gamerboy166,245,187,58,
454,TheenivU,245,203,42,
455,The Almighty Pegasus Epsilon,245,185,60,
456,Chrisfox,245,187,58,
457,Bax,245,169,76,
458,Connor Kenway,245,171,74,
459,Tomnar,245,205,40,
460,Space Monkey,245,189,56,
461,alexey007gold,245,197,48,
462,Ryan,245,173,72,
463,ierdna100,246,172,74,
464,ggg1psyyy,246,172,74,
465,Derwall,246,172,74,
466,GuyWithLag,246,172,74,
467,nathanmb41,246,172,74,
468,Threadzless,246,172,74,
469,Yoann,246,172,74,
470,wogget,246,206,40,
471,å¤§é’Š,246,172,74,
472,tobias.bodewig,246,172,74,
473,cat2002,246,172,74,
474,SlashLife,246,172,74,
475,ErefeWinter,246,172,74,
476,ilikelogicdesign,246,172,74,
477,Suibeom,246,172,74,
478,kremnev8,246,172,74,
479,oeniehead,246,172,74,
480,RoflCopter,246,210,36,
481,eiowlta,246,172,74,
482,imagineaclevernamehere,246,172,74,
483,,246,172,74,
484,早起失败重启中,246,212,34,
485,RoiboschT,246,172,74,
486,Pyr0Spr1t3,246,172,74,
487,digit777,246,172,74,
488,Bohbas,246,172,74,
489,corncob22,246,172,74,
490,NaniteL,246,172,74,
491,Asmodayys,246,172,74,
492,Rolnadlo,246,172,74,
493,Fluteboy123,246,172,74,
494,milo,246,172,74,
495,orbspiral,246,172,74,
496,iceypoi,246,172,74,
497,xris,246,172,74,
498,Damjes,246,172,74,
499,Porter,246,172,74,
500,Ravenslofty,246,172,74,
501,The C.I.A. (F7FF),246,212,34,
502,Renelene,246,172,74,
503,Vanilla Gorilla,246,172,74,
504,Dr. Ninja,246,172,74,
505,herasae25,246,174,72,
506,Karechta,246,172,74,
507,Martian,246,172,74,
508,Smeech,246,172,74,
509,Swek,246,172,74,
510,1711386997,246,172,74,
511,r13x,246,172,74,
512,ThisDoesNotExist,246,206,40,
513,ã‚¹ãƒ†ãƒ•ã‚¡ãƒ³ã€€ï¼ã€€æ—¥æœ¬äººã¯å¤‰ã,246,172,74,
514,ukey79,246,172,74,
515,Dem,246,174,72,
516,ukey79,246,172,74,
517,piroot7,246,172,74,
518,Y,246,172,74,
519,xiemingdao20101119,246,172,74,
520,袖酋成羿,246,172,74,
521,MhwWHU,246,172,74,
522,qq123151998823,246,172,74,
523,rlsgkscka,246,172,74,
524,MG moves 5m to the left,246,172,74,
525,banzif,247,187,60,
526,Speedy,247,193,54,
527,that temperature,247,173,74,
528,绘音c,247,201,46,
529,sKnave,247,173,74,
530,嘟嘟,247,173,74,
531,Cookie,247,173,74,
532,Ann drew,247,175,72,
533,传说好杰瑞,247,173,74,
534,Carlo,247,205,42,
535,Alien Valkyrie,248,202,46,
536,The Ass Kicker,248,200,48,
537,Foulgaz3,248,174,74,
538,palaeoabyss,248,216,32,
539,PGForest,248,202,46,
540,weermee,248,172,76,
541,aaaaaa,248,178,70,
542,Zaratul9,249,223,26,
543,ãã•ã‚‰ãŽ,249,175,74,
544,sneaky.ruds,249,171,78,
545,HL65536,249,211,38,
546,SebaH,249,205,44,
547,KingCam16,249,179,70,
548,GaryTavish,249,211,38,
549,tonym1972,249,215,34,
550,duan,249,197,52,
551,AArnett79,249,179,70,
552,lurfy3,249,175,74,
553,Not a Cylon,250,210,40,
554,gaylod,250,174,76,
555,SamuraiPDF,250,176,74,
556,xenoexplorator,250,206,44,
557,Prince\_R,250,174,76,
558,General,250,202,48,
559,xfacthd,250,176,74,
560,大空白菌,250,174,76,
561,Garfieldcmix,250,218,32,
562,Johan,250,174,76,
563,Indigo,250,174,76,
564,zaubara,250,214,36,
565,TypicalKing03,250,174,76,
566,Esperan,251,191,60,
567,Zortan,251,173,78,
568,SkumHubber,251,175,76,
569,martin,251,197,54,
570,wickie37,251,197,54,
571,rsprinkle,251,181,70,
572,Tecnifighter,251,175,76,
573,donottellmetonottellyou,251,175,76,
574,myslee angel,251,213,38,
575,s1d3sw1ped,252,172,80,
576,Raptor-Eins-Null,252,226,26,
577,Hblymer,252,196,56,
578,DemiurgE,252,188,64,
579,TehCranium,252,212,40,
580,DraconicAsh,252,218,34,
581,Ixam,252,208,44,
582,Lemiteus,253,177,76,
583,Bugs Bunny,253,173,80,
584,LittleDemon,253,213,40,
585,Robot\_V1,253,209,44,
586,TheKillerbyte,253,207,46,
587,BrotherMordigael,253,173,80,
588,PythonGermany,253,205,48,
589,zhangsiwei1951,253,211,42,
590,Philfreeze,253,177,76,
591,dmdeemer,253,217,36,
592,Tsukina_7mochi,254,196,58,
593,Greg0lord,254,194,60,
594,Xelote,254,180,74,
595,Techie,254,208,46,
596,letitia.tiba,254,180,74,
597,Lanterns,254,216,38,
598,HOI,254,218,36,
599,tater600,254,204,50,
600,christopher\_hayden,254,216,38,
601,the_sphine,254,176,78,
602,dadolphinplayz,254,206,48,
603,Artsy E.,254,230,24,
604,1304497636,254,194,60,
605,jeremiejig,254,226,28,
606,Ch1pless,254,194,60,
607,Fuck Women Apparently,254,180,74,
608,Adaliah Zev,254,204,50,
609,Jpiv1212,254,196,58,
610,IM&SD,254,234,20,
611,Lord Le Brand,254,180,74,
612,LuxraySpiral,254,180,74,
613,dmitry.vnukov,254,180,74,
614,1919124193,254,180,74,
615,The_Dark_Jumper,255,205,50,
616,jacoblong853,255,181,74,
617,Nikke,255,181,74,
618,DestinyHailstorm,255,229,26,
619,CodeZ,256,218,38,
620,morfey832,256,202,54,
621,Alex,256,194,62,
622,جهنم,256,184,72,
623,Robthehood,256,206,50,
624,AbelianGrape,257,213,44,
625,pinkertona,257,181,76,
626,Arctic,257,169,88,
627,Dorcas,257,201,56,
628,MoFan,257,187,70,
629,Akiro,257,187,70,
630,Ardour,257,197,60,
631,\_\_INT,257,187,70,
632,Sovde,257,219,38,
633,phiphi.282,257,187,70,
634,NNN1590,257,169,88,
635,1358154562,257,205,52,
636,calvin.love,258,188,70,
637,^\_^^0tankjb,259,225,34,
638,Alter,259,221,38,
639,Y-32,259,221,38,
640,That Guy,259,189,70,
641,Saoirse,259,205,54,
642,InKryption,259,219,40,
643,Murzahg,259,207,52,
644,Blubber,260,200,60,
645,Whelmed,260,220,40,
646,Zeltix,260,218,42,
647,Tranquil\_Zebra,260,188,72,
648,小软君,260,190,70,
649,yvettedeland,260,218,42,
650,1Kick234,260,206,54,
651,Horschtele,261,189,72,
652,No. 4,261,217,44,
653,Fragath,261,235,26,
654,skeltoac,261,201,60,
655,freezecubed,261,189,72,
656,CurryField,262,188,74,
657,Rominos2,262,200,62,
658,syockit,262,216,46,
659,Wutnudel,262,188,74,
660,amarende,262,188,74,
661,Penetrat0r,262,188,74,
662,Roolk,262,188,74,
663,andriuxj,262,188,74,
664,Sergeant Whiskers,262,188,74,
665,FinFanFinne,262,188,74,
666,Tobias Rex,262,188,74,
667,jcouch210,262,188,74,
668,EternalBlue,262,188,74,
669,SharkyTheWhite,262,188,74,
670,嘉 禾 天 橙 國 際 影 院,262,188,74,
671,zx,262,188,74,
672,Alrune,262,222,40,
673,Artentus,262,188,74,
674,singlethread,262,222,40,
675,ç”˜ãªãŠ/amanao,262,188,74,
676,CyKid128,262,188,74,
677,Pulmilitis,262,204,58,
678,kubanvip,262,212,50,
679,popty,262,188,74,
680,stjfinch,262,188,74,
681,Air Man,262,188,74,
682,AdePlay,262,188,74,
683,CakeFTW,262,188,74,
684,wolly01,262,188,74,
685,Monad,262,188,74,
686,zacks,262,188,74,
687,kuba333x333x333x333,262,188,74,
688,ekinohito,262,188,74,
689,guru\_meditation\_05,262,188,74,
690,Zincfox,262,188,74,
691,ShannonSHANG,262,212,50,
692,quantumoptics,262,188,74,
693,Peppw_,263,189,74,
694,Asgar,263,189,74,
695,Vetinari,263,189,74,
696,Moe,263,189,74,
697,Methane Oceans,263,189,74,
698,Shadow Spade,263,175,88,
699,Deonicron,263,189,74,
700,Voltara,263,189,74,
701,Tyrannical Bean,263,189,74,
702,secondeblue,263,189,74,
703,sewbacca,263,213,50,
704,Shaori Fell,263,203,60,
705,Gheutx,263,205,58,
706,macmillan1702,263,189,74,
707,guilhermecordeiro,263,213,50,
708,zerocool,264,188,76,
709,ASH,264,188,76,
710,cum 1,264,216,48,
711,asas,264,188,76,
712,Tomas,264,208,56,
713,Motion-Sensing Paperclip,264,188,76,
714,Mocevaz,264,216,48,
715,llfull,264,188,76,
716,WrongHeaven,265,189,76,
717,Gamer Deluxe 01,265,189,76,
718,igoral,265,235,30,
719,Newbie,265,189,76,
720,Unmaple,265,189,76,
721,stehsaer,265,203,62,
722,ricardovbree,265,189,76,
723,jiangzijun0326,265,191,74,
724,cerealandsandwiches,266,230,36,
725,Baked Potato,266,236,30,
726,1189515976,266,220,46,
727,Mortalitor,267,227,40,
728,Igniculus Fu,267,193,74,
729,zzzzzz,267,197,70,
730,Zachava,267,165,102,
731,caelaise,267,221,46,
732,卧嫩蝶,267,227,40,
733,ente,267,229,38,
734,darrone79969,268,220,48,
735,Grøker NOOOOB,268,192,76,
736,BoJonas[DK],268,220,48,
737,Binaryclock03,268,192,76,
738,leoleelix,268,192,76,
739,Itnug,268,222,46,
740,HSENX,268,190,78,
741,xSwan,268,210,58,
742,hhr20202020,268,244,24,
743,Hippie,268,198,70,
744,viktor.zweiundvierzig,268,188,80,
745,d4harp,268,196,72,
746,LeonidR,268,178,90,
747,ucals,268,190,78,
748,Paul,269,237,32,
749,Charge Cruiser,269,229,40,
750,Aylvaer,269,219,50,
751,Utopioshere,269,197,72,
752,deliberate_guess,269,205,64,
753,DemonSlayer1123,269,205,64,
754,zxl995638576,269,197,72,
755,lekkel124,269,215,54,
756,Nimmy Nurner,269,197,72,
757,segelnhoch3,269,225,44,
758,iecheuch,269,189,80,
759,flowersfly,269,219,50,
760,Awesomeness211i,270,226,44,
761,winibo,270,226,44,
762,EnticingCanine,270,192,78,
763,steven,270,216,54,
764,TechnoMancer,270,184,86,
765,PsychoToast,270,196,74,
766,kembo,270,210,60,
767,mekb the turtle,270,222,48,
768,Penguin3000,270,196,74,
769,Schadocnico,270,230,40,
770,eyeKi1ler,270,196,74,
771,Durlock,270,196,74,
772,Aphadion,270,206,64,
773,Ericloewe,270,194,76,
774,ishio,270,234,36,
775,Douba,270,196,74,
776,Davyre,270,194,76,
777,CryThis,270,196,74,
778,Cinnamonbun,270,196,74,
779,冰糖,270,196,74,
780,ó ‡°,271,207,64,
781,ZKlack,271,197,74,
782,Imalish,271,197,74,
783,karatecatkaleb,271,197,74,
784,flamenbird,271,197,74,
785,xLife | Felix,271,197,74,
786,Darkflam3,271,197,74,
787,2393916716,271,197,74,
788,ben.miller,271,197,74,
789,EndGamer,271,197,74,
790,牧濑红莉栖,271,233,38,
791,HELLOWORLD,271,197,74,
792,ECanDo,271,197,74,
793,xyvm,271,231,40,
794,lspirido,271,197,74,
795,smoothbandit9,271,247,24,
796,baschwar,271,197,74,
797,silkroadalice,271,197,74,
798,Vincent\_wang,271,197,74,
799,Compilatron,271,197,74,
800,Myitian,271,197,74,
801,手把练习生 HAET,271,199,72,
802,KisVilmos27,271,197,74,
803,加油特种兵 帅哥雷,271,197,74,
804,Zaxabock,272,246,26,
805,BabyThor,272,220,52,
806,L Canis,272,224,48,
807,maokky,272,202,70,
808,TloBow,272,196,76,
809,Dolg,272,192,80,
810,keldor,273,241,32,
811,Policegking,273,197,76,
812,rossau,273,235,38,
813,AddAttension,273,197,76,
814,LampshadeJustice,273,197,76,
815,KISARAGI,273,247,26,
816,Oddium,273,197,76,
817,Paper-Boy,273,197,76,
818,Mascote DDOS,273,231,42,
819,CrafterFB,273,227,46,
820,BastJahn,273,213,60,
821,Frosty,273,247,26,
822,CBA_97,273,197,76,
823,alex,274,232,42,
824,RedzGone,274,220,54,
825,nat,274,198,76,
826,hlynurj,274,232,42,
827,Evil russian Ivan,274,216,58,
828,JSRagman,274,226,48,
829,Achilles,274,200,74,
830,ratsch1964,275,195,80,
831,Unmeinks,275,227,48,
832,anderspinholt,275,205,70,
833,Furan867,275,251,24,
834,KaWeNGoD,275,249,26,
835,ღ「星空物语」,275,245,30,
836,Mackan,276,244,32,
837,Lily,276,198,78,
838,上古尊者慢羊羊,276,202,74,
839,Tuskator,276,240,36,
840,你看不到我你看不到我,276,202,74,
841,orangebird,276,226,50,
842,ButterSus,276,244,32,
843,Taril\_Aran,276,232,44,
844,iwashi,276,212,64,
845,tan((x^2) (y^2))=0,276,252,24,
846,2978681606,276,244,32,
847,TheAlienAlan,277,195,82,
848,jean_mi2002fr,277,201,76,
849,Beemer,277,217,60,
850,tfalderson,277,211,66,
851,Taffy,277,251,26,
852,pv2b,277,233,44,
853,Fuchssi987,277,201,76,
854,zuiemimi,277,253,24,
855,GrayV60,277,251,26,
856,zxc,277,213,64,
857,Freakonomicon,277,229,48,
858,TriMay,277,227,50,
859,RetiredRogue,277,205,72,
860,Toxic Child,277,251,26,
861,Silentsouls,278,196,82,
862,FireyOne2,278,206,72,
863,JM445,278,204,74,
864,Benni,278,244,34,
865,Soup,278,172,106,
866,Hinara,278,228,50,
867,jpuryear,278,228,50,
868,0xCA13B,278,172,106,
869,R.Coulson,278,188,90,
870,2541574718,278,204,74,
871,Laggy Lagomorph,278,172,106,
872,璃空GLASSAIR,278,204,74,
873,Just King,278,204,74,
874,robbob,278,208,70,
875,Y\_Corp,278,230,48,
876,Zenith,278,206,72,
877,Thaui,278,228,50,
878,夜与火光,278,208,70,
879,ihoo,278,202,76,
880,Black Yam,278,204,74,
881,Mr Greggles,278,204,74,
882,Shadow\_Fury,278,172,106,
883,seth.sims,278,196,82,
884,UnsignedRobin,279,247,32,
885,ThatMcFlyGuy,279,239,40,
886,*****,279,173,106,
887,cocoshen,279,255,24,
888,yrdns,279,205,74,
889,Enryse,279,219,60,
890,2585191715,279,205,74,
891,Lumapup,279,205,74,
892,DDG175,279,205,74,
893,NZPIEFACE,279,205,74,
894,Napoleon5566,279,229,50,
895,危笑\_,279,247,32,
896,odfelix06,280,246,34,
897,\_CodeGreen,280,204,76,
898,Dave,280,252,28,
899,Wheel,280,232,48,
900,Prawn Crackers,281,255,26,
901,DrummerB,281,227,54,
902,Cosmo,281,243,38,
903,Zlug,281,233,48,
904,PrincessWeng,281,205,76,
905,だばー,281,205,76,
906,z3d1k,281,209,72,
907,安达岛村一生推,281,205,76,
908,MikeNotIke,281,205,76,
909,Geodecillium,281,253,28,
910,climb4life,282,198,84,
911,rogue78,282,206,76,
912,Blitz Tiger,282,204,78,
913,wyp020610,282,194,88,
914,hijam76,282,208,74,
915,prout.prout,282,204,78,
916,,282,234,48,
917,Jpkrowe,282,242,40,
918,henry4412,282,236,46,
919,Blu3,282,232,50,
920,Fenrir,283,201,82,
921,Demolitron,283,191,92,
922,super_craft_alex,283,195,88,
923,SuperFluffyGame,283,195,88,
924,kroutu,283,235,48,
925,Murwen,283,243,40,
926,dn6049949,283,197,86,
927,TooMuchDog,283,235,48,
928,Dave,284,248,36,
929,Eutian,284,196,88,
930,derEntenpopel,284,250,34,
931,530835922,284,252,32,
932,Rajomaxx,284,230,54,
933,ENCHANTMEN,284,188,96,
934,Subonaut,285,251,34,
935,Hiro,285,257,28,
936,kkumie,285,231,54,
937,qbax,285,227,58,
938,XuanYun\_Morax,285,227,58,
939,Tarzy,285,247,38,
940,1830395354,285,247,38,
941,fimasu,286,202,84,
942,leon_stue,286,212,74,
943,Attikitty,286,180,106,
944,Carcipomme,286,212,74,
945,HS The 10th,286,212,74,
946,mbmgfnbk,287,213,74,
947,mail7,287,213,74,
948,dapperapple,287,199,88,
949,ZymmAc,287,213,74,
950,VolkSWAGen,287,247,40,
951,Maxfranz10,287,213,74,
952,stringbean,287,213,74,
953,XuanX,287,213,74,
954,Tanner07,287,201,86,
955,c20xM3k=,287,207,80,
956,Belale,287,213,74,
957,Joe Parmigiano,287,213,74,
958,Raccoons,287,249,38,
959,sammyhawk,287,255,32,
960,1764,287,213,74,
961,awa,287,213,74,
962,Fredrik,287,213,74,
963,Yaoi Gagarin,287,213,74,
964,Saltxwater,287,213,74,
965,vinicius-dias-c,287,213,74,
966,DevilVsLife,287,259,28,
967,yici1249,287,213,74,
968,GN6,287,227,60,
969,pukin2up,287,213,74,
970,PQPEQR,287,213,74,
971,Samusbot,288,200,88,
972,AidanMars,288,242,46,
973,robert.david.grossman,288,240,48,
974,唐龙,288,214,74,
975,just me,288,210,78,
976,Slug,288,254,34,
977,虾仁猪心,288,214,74,
978,kuparikana,288,190,98,
979,minamon,288,214,74,
980,刮骨刀黛娜娜,288,214,74,
981,Karzana,289,203,86,
982,wojteketjow,289,239,50,
983,Hackling_92,289,237,52,
984,Pizzasgood,289,251,38,
985,Dargonrol,289,197,92,
986,theduck,289,211,78,
987,Ziutek,289,213,76,
988,GulaschKumpl,289,209,80,
989,Furina#89757,289,259,30,
990,SysLord,290,188,102,
991,Frost,290,212,78,
992,Bllum,290,266,24,
993,TheMightyBiz,290,214,76,
994,Aris,290,216,74,
995,todd.blackmon,290,200,90,
996,Slice,290,214,76,
997,Docteur Who,290,212,78,
998,Dwight knight,290,228,62,
999,Luke,290,236,54,
1000,HImcdonough,291,223,68,
